NO ./textures/teste.xpm
SO ./textures/teste.xpm
WE ./textures/teste.xpm
EA ./textures/teste.xpm
F 255,255,0
C 225,255,0

        1111111111111111111111111
        1000000000110000000000001
        1011000001110000000000001
        1001000000000000000000001
111111111011000001110000000000001
100000000011000000010111111111111
11110111111111011100000000001
11110111111111011100100010001
11000000110101011100010000101
10000000000000000000000000001
10000000000000001101010N00001
1100000111010101111101110000111
11110111 1110101 101111000001
11111111 1111111 111111111111