NO ./textures/teste.xpm
SO ./textures/teste.xpm
WE ./textures/teste.xpm
EA ./textures/teste.xpm
F 225,55,0
C 255,255,0

11111111111111
10000000000001
100S0000000001
10000000000001
10000000000001
10000000000001
10000000000001
10000000000001
11111111111111