NO ./textures/teste.xpm
SO ./textures/teste.xpm
WE ./textures/teste.xpm
EA ./textures/teste.xpm
F 255,255,0
C 225,255,0

11111
10001
10N01
10001
11111