NO ./textures/teste.xpm
SO ./textures/teste.xpm
WE ./textures/teste.xpm
EA ./textures/teste.xpm
F 255,255,0
C 225,255,0

111111111111111111111111111111111111
100000000000000000000000000000000001
100000000000000000000000000000000001
1000000000000000000000000000000000011111111111111
1000000000000001111000000000000000000000000000001
1000100000000000000000000000000000000000000000001
10001000000000000S0000000000000000000000000000001
1000100000000000000000000000000000000000000000001
1000000000000000000000000000000000000000000000001
1000000000000000000000000000000000011111111111111
100000000000000000000000000000000001
100000000000000000000000000000000001
111111111111111111111111111111111111